17,5,5,5,5,5,5,5,5,5,5,5,5,5,5,5,5,5,5,5,5,5,5,17
17,5,5,5,5,5,5,5,5,5,5,5,5,5,5,5,5,5,5,5,5,5,5,17
17,5,5,5,5,5,5,5,5,5,5,5,5,5,5,5,5,5,5,5,5,5,5,17
17,5,5,5,5,5,5,5,5,5,5,5,5,5,5,5,5,5,5,5,5,5,5,17
17,5,5,5,5,5,5,5,5,5,5,5,5,5,5,5,5,5,5,5,5,5,5,17
17,5,5,5,5,5,5,5,5,5,5,5,5,5,5,5,5,5,5,5,5,5,5,17
17,5,5,5,5,5,5,5,5,5,5,5,5,5,5,5,5,5,5,5,5,5,5,17
17,5,5,5,5,5,5,5,5,5,5,5,5,5,5,5,5,5,5,5,5,5,5,17
17,5,5,5,5,5,5,5,5,5,5,5,5,5,5,5,5,5,5,5,5,5,5,17
17,5,5,5,5,5,5,5,5,5,5,5,5,5,5,5,5,5,5,5,5,5,5,17
17,5,5,5,5,5,5,5,5,5,5,5,5,5,5,5,5,5,5,5,5,5,5,17
17,5,5,5,5,5,5,5,5,5,5,5,5,5,5,5,5,5,5,5,5,5,5,17
17,5,5,5,5,5,5,5,5,5,5,5,5,5,5,5,5,5,5,5,5,5,5,17
17,5,5,5,5,5,5,5,5,5,5,5,5,5,5,5,5,5,5,5,5,5,5,17
17,5,5,5,5,5,5,5,5,5,5,5,5,5,5,5,5,5,5,5,5,5,5,17
17,5,5,5,5,5,5,5,5,5,5,5,5,5,5,5,5,5,5,5,5,5,5,17
17,5,5,5,5,5,5,5,5,5,5,5,5,5,5,5,5,5,5,5,5,5,5,17
17,5,5,5,5,5,5,5,5,5,5,5,5,5,5,5,5,5,5,5,5,5,5,17
17,5,5,5,5,5,5,5,5,5,5,5,5,5,5,5,5,5,5,5,5,5,5,17
17,5,5,5,5,5,5,5,5,5,5,5,5,5,5,5,5,5,5,5,5,5,5,17
17,5,5,5,5,5,5,5,5,5,5,5,5,5,5,5,5,5,5,5,5,5,5,17
17,5,5,5,5,5,5,5,5,5,5,5,5,5,5,5,5,5,5,5,5,5,5,17
17,5,5,5,5,5,5,5,5,5,5,5,5,5,5,5,5,5,5,5,5,5,5,17
17,5,5,5,5,5,5,5,5,5,5,5,5,5,5,5,5,5,5,5,5,5,5,17
17,5,5,5,5,5,5,5,5,5,5,5,5,5,5,5,5,5,5,5,5,5,5,17
17,5,5,5,5,5,5,5,5,5,5,5,5,5,5,5,5,5,5,5,5,5,5,17
17,5,5,5,5,5,5,5,5,5,5,5,5,5,5,5,5,5,5,5,5,5,5,17
17,5,5,5,5,5,5,5,5,5,5,5,5,5,5,5,5,5,5,5,5,5,5,17
17,5,5,5,5,5,5,5,5,5,5,5,5,5,5,5,5,5,5,5,5,5,5,17
17,5,5,5,5,5,5,5,5,5,5,5,5,5,5,5,5,5,5,5,5,5,5,17
17,5,5,5,5,5,5,5,5,5,5,5,5,5,5,5,5,5,5,5,5,5,5,17
17,5,5,5,5,5,5,5,5,5,5,5,5,5,5,5,5,5,5,5,5,5,5,17
17,5,5,5,5,5,5,5,5,5,5,5,5,5,5,5,5,5,5,5,5,5,5,17
17,5,5,5,5,5,5,5,5,5,5,5,5,5,5,5,5,5,5,5,5,5,5,17
17,5,5,5,5,5,5,5,5,5,5,5,5,5,5,5,5,5,5,5,5,5,5,17
17,5,5,5,5,5,5,5,5,5,5,5,5,5,5,5,5,5,5,5,5,5,5,17
17,5,5,5,5,5,5,5,5,5,5,5,5,5,5,5,5,5,5,5,5,5,5,17
17,5,5,5,5,5,5,5,5,5,5,5,5,5,5,5,5,5,5,5,5,5,5,17
17,5,5,5,5,5,5,5,5,5,5,5,5,5,5,5,5,5,5,5,5,5,5,17
17,5,5,5,5,5,5,5,5,5,5,5,5,5,5,5,5,5,5,5,5,5,5,17
17,5,5,5,5,5,5,5,5,5,5,5,5,5,5,5,5,5,5,5,5,5,5,17
17,5,5,5,5,5,5,5,5,5,5,5,5,5,5,5,5,5,5,5,5,5,5,17
17,5,5,5,5,5,5,5,5,5,5,5,5,5,5,5,5,5,5,5,5,5,5,17
17,5,5,5,5,5,5,5,5,5,5,5,5,5,5,5,5,5,5,5,5,5,5,17
17,5,5,5,5,5,5,5,5,5,5,5,5,5,5,5,5,5,5,5,5,5,5,17
17,5,5,5,5,5,5,5,5,5,5,5,5,5,5,5,5,5,5,5,5,5,5,17
17,5,5,5,5,5,5,5,5,5,5,5,5,5,5,5,5,5,5,5,5,5,5,17
17,5,5,5,5,5,5,5,5,5,5,5,5,5,5,5,5,5,5,5,5,5,5,17
17,5,5,5,5,5,5,5,5,5,5,5,5,5,5,5,5,5,5,5,5,5,5,17
17,5,5,5,5,5,5,5,5,5,5,5,5,5,5,5,5,5,5,5,5,5,5,17
17,5,5,5,5,5,5,5,5,5,5,5,5,5,5,5,5,5,5,5,5,5,5,17
17,5,5,5,5,5,5,5,5,5,5,5,5,5,5,5,5,5,5,5,5,5,5,17
17,5,5,5,5,5,5,5,5,5,5,5,5,5,5,5,5,5,5,5,5,5,5,17
17,5,5,5,5,5,5,5,5,5,5,5,5,5,5,5,5,5,5,5,5,5,5,17
17,5,5,5,5,5,5,5,5,5,5,5,5,5,5,5,5,5,5,5,5,5,5,17
17,5,5,5,5,5,5,5,5,5,5,5,5,5,5,5,5,5,5,5,5,5,5,17
17,5,5,5,5,5,5,5,5,5,5,5,5,5,5,5,5,5,5,5,5,5,5,17
17,5,5,5,5,5,5,5,5,5,5,5,5,5,5,5,5,5,5,5,5,5,5,17
17,5,5,5,5,5,5,5,5,5,5,5,5,5,5,5,5,5,5,5,5,5,5,17
17,5,5,5,5,5,5,5,5,5,5,5,5,5,5,5,5,5,5,5,5,5,5,17
17,5,5,5,5,5,5,5,5,5,5,5,5,5,5,5,5,5,5,5,5,5,5,17
17,5,5,5,5,5,5,5,5,5,5,5,5,5,5,5,5,5,5,5,5,5,5,17
17,5,5,5,5,5,5,5,5,5,5,5,5,5,5,5,5,5,5,5,5,5,5,17
17,5,5,5,5,5,5,5,5,5,5,5,5,5,5,5,5,5,5,5,5,5,5,17
17,5,5,5,5,5,5,5,5,5,5,5,5,5,5,5,5,5,5,5,5,5,5,17
17,5,5,5,5,5,5,5,5,5,5,5,5,5,5,5,5,5,5,5,5,5,5,17
17,5,5,5,5,5,5,5,5,5,5,5,5,5,5,5,5,5,5,5,5,5,5,17
17,5,5,5,5,5,5,5,5,5,5,5,5,5,5,5,5,5,5,5,5,5,5,17
17,5,5,5,5,5,5,5,5,5,5,5,5,5,5,5,5,5,5,5,5,5,5,17
17,5,5,5,5,5,5,5,5,5,5,5,5,5,5,5,5,5,5,5,5,5,5,17
17,5,5,5,5,5,5,5,5,5,5,5,5,5,5,5,5,5,5,5,5,5,5,17
17,5,5,5,5,5,5,5,5,5,5,5,5,5,5,5,5,5,5,5,5,5,5,17
17,5,5,5,5,5,5,5,5,5,5,5,5,5,5,5,5,5,5,5,5,5,5,17
17,5,5,5,5,5,5,5,5,5,5,5,5,5,5,5,5,5,5,5,5,5,5,17
17,5,5,5,5,5,5,5,5,5,5,5,5,5,5,5,5,5,5,5,5,5,5,17
17,5,5,5,5,5,5,5,5,5,5,5,5,5,5,5,5,5,5,5,5,5,5,17
17,5,5,5,5,5,5,5,5,5,5,5,5,5,5,5,5,5,5,5,5,5,5,17
17,5,5,5,5,5,5,5,5,5,5,5,5,5,5,5,5,5,5,5,5,5,5,17
17,5,5,5,5,5,5,5,5,5,5,5,5,5,5,5,5,5,5,5,5,5,5,17
17,5,5,5,5,5,5,5,5,5,5,5,5,5,5,5,5,5,5,5,5,5,5,17
17,5,5,5,5,5,5,5,5,5,5,5,5,5,5,5,5,5,5,5,5,5,5,17
17,5,5,5,5,5,5,5,5,5,5,5,5,5,5,5,5,5,5,5,5,5,5,17
17,5,5,5,5,5,5,5,5,5,5,5,5,5,5,5,5,5,5,5,5,5,5,17
17,5,5,5,5,5,5,5,5,5,5,5,5,5,5,5,5,5,5,5,5,5,5,17
17,5,5,5,5,5,5,5,5,5,5,5,5,5,5,5,5,5,5,5,5,5,5,17
17,5,5,5,5,5,5,5,5,5,5,5,5,5,5,5,5,5,5,5,5,5,5,17
17,5,5,5,5,5,5,5,5,5,5,5,5,5,5,5,5,5,5,5,5,5,5,17
17,5,5,5,5,5,5,5,5,5,5,5,5,5,5,5,5,5,5,5,5,5,5,17
17,5,5,5,5,5,5,5,5,5,5,5,5,5,5,5,5,5,5,5,5,5,5,17
17,5,5,5,5,5,5,5,5,5,5,5,5,5,5,5,5,5,5,5,5,5,5,17
17,5,5,5,5,5,5,5,5,5,5,5,5,5,5,5,5,5,5,5,5,5,5,17
17,5,5,5,5,5,5,5,5,5,5,5,5,5,5,5,5,5,5,5,5,5,5,17
17,5,5,5,5,5,5,5,5,5,5,5,5,5,5,5,5,5,5,5,5,5,5,17
17,5,5,5,5,5,5,5,5,5,5,5,5,5,5,5,5,5,5,5,5,5,5,17
17,5,5,5,5,5,5,5,5,5,5,5,5,5,5,5,5,5,5,5,5,5,5,17
17,5,5,5,5,5,5,5,5,5,5,5,5,5,5,5,5,5,5,5,5,5,5,17
17,5,5,5,5,5,5,5,5,5,5,5,5,5,5,5,5,5,5,5,5,5,5,17
17,5,5,5,5,5,5,5,5,5,5,5,5,5,5,5,5,5,5,5,5,5,5,17
17,5,5,5,5,5,5,5,5,5,5,5,5,5,5,5,5,5,5,5,5,5,5,17
17,5,5,5,5,5,5,5,5,5,5,5,17,17,17,5,5,5,5,5,5,5,5,17
17,5,5,5,5,5,5,5,5,5,5,5,17,5,5,5,5,5,5,5,5,5,5,17
17,5,5,5,5,5,5,5,5,5,5,5,17,5,5,5,5,5,5,5,5,5,5,17
17,5,5,5,5,5,5,5,5,5,5,5,17,5,5,17,17,17,17,17,17,5,5,17
17,5,5,5,5,5,5,5,5,5,5,5,17,5,5,17,17,5,5,17,17,5,5,17
17,5,5,5,5,5,5,5,5,5,5,5,17,5,5,5,5,5,5,5,5,5,5,17
17,5,5,5,5,5,5,5,5,5,5,5,17,5,5,5,5,5,5,5,5,5,5,17
17,5,5,5,5,5,5,5,5,5,5,5,17,5,5,5,5,5,5,5,5,5,5,17
17,5,5,5,5,5,5,5,5,5,5,5,17,5,5,5,5,5,5,5,5,5,5,17
17,5,5,5,5,5,5,5,5,5,5,5,17,5,5,17,17,5,5,17,17,5,5,17
17,5,5,5,5,5,5,5,5,5,5,5,17,5,5,17,17,5,5,17,17,5,5,17
17,5,5,5,5,5,5,5,5,5,5,5,17,5,5,5,5,5,5,5,5,5,5,17
17,5,5,5,5,5,5,5,5,5,5,5,17,5,5,5,5,5,5,5,5,5,5,17
17,5,5,5,5,5,5,5,5,5,5,5,17,5,5,5,5,5,5,5,5,5,5,17
17,5,5,5,5,5,5,5,5,5,5,5,17,5,5,5,5,5,5,5,5,5,5,17
17,5,5,5,5,5,5,5,5,5,5,5,17,5,5,17,17,5,5,17,17,5,5,17
17,5,5,5,5,5,5,5,5,5,5,5,17,5,5,17,17,5,5,17,17,5,5,17
17,5,5,5,5,5,5,5,5,5,5,5,17,5,5,5,5,5,5,5,5,5,5,17
17,5,5,5,5,5,5,5,5,5,5,5,17,5,5,5,5,5,5,5,5,5,5,17
17,5,5,5,5,5,5,5,5,5,5,5,17,5,5,17,17,17,17,17,5,5,5,17
17,5,5,5,5,5,5,5,5,5,5,5,17,5,5,5,5,5,5,17,5,5,5,17
17,5,5,5,5,5,5,5,5,5,5,5,17,5,5,5,5,5,5,17,5,5,5,17
17,5,5,5,5,5,5,5,5,5,5,5,17,17,17,17,5,5,5,17,5,5,5,17
17,5,5,5,5,5,5,5,5,5,5,5,17,5,5,5,5,5,5,17,5,5,5,17
17,5,5,5,5,5,5,5,5,5,5,5,17,5,5,5,5,5,5,17,5,5,5,17
17,5,5,5,5,5,5,5,5,5,5,5,17,5,5,5,5,5,5,17,5,5,5,17
17,5,5,5,5,5,5,5,5,5,5,5,17,17,17,17,17,5,5,17,5,5,5,17
17,5,5,5,5,5,5,5,5,5,5,5,17,5,5,5,5,5,5,17,5,5,5,17
17,5,5,5,5,5,5,5,5,5,5,5,17,5,5,5,5,5,5,17,5,5,5,17
17,5,5,5,5,5,5,5,5,5,5,5,17,5,5,17,17,17,17,17,5,5,5,17
17,5,5,5,5,5,5,5,5,5,5,5,17,5,5,5,5,5,5,17,5,5,5,17
17,5,5,5,5,5,5,5,5,5,5,5,17,5,5,5,5,5,5,17,5,5,5,17
17,5,5,5,5,5,5,5,5,5,5,5,17,17,17,17,17,5,5,17,5,5,5,17
17,5,5,5,5,5,5,5,5,5,5,5,17,5,5,5,5,5,5,17,5,5,5,17
17,5,5,5,5,5,5,5,5,5,5,5,17,5,5,5,5,5,5,17,5,5,5,17
17,5,5,5,5,5,5,5,5,5,5,5,17,5,5,17,17,17,17,17,5,5,5,17
17,5,5,5,5,5,5,5,5,5,5,5,17,5,5,5,5,5,5,5,5,5,5,17
17,5,5,5,5,5,5,5,5,5,5,5,17,5,5,5,5,5,5,5,5,5,5,17
17,5,5,5,5,5,5,5,5,5,5,5,17,17,17,17,17,5,5,5,5,5,5,17
17,5,5,5,5,5,5,5,5,5,5,5,5,5,5,5,5,5,5,5,5,5,5,17
17,5,5,5,5,5,5,5,5,5,5,5,5,5,5,5,5,5,5,5,5,5,5,17
17,5,5,5,5,5,5,5,5,5,5,5,5,5,5,5,17,17,17,17,17,17,17,17
17,5,5,5,5,5,5,5,5,5,5,5,5,5,5,5,5,5,5,5,5,5,5,17
17,5,5,5,5,5,5,5,5,5,5,5,5,5,5,5,5,5,5,5,5,5,5,17
17,5,5,5,5,5,5,5,5,5,5,5,5,5,5,5,5,5,5,5,5,5,5,17
17,5,5,5,5,5,5,5,5,5,5,5,5,17,17,5,5,5,5,5,5,5,5,17
17,5,5,5,5,5,5,5,5,5,5,5,5,17,17,5,5,5,5,5,5,5,5,17
17,5,5,5,5,5,5,5,5,5,5,5,5,17,17,5,5,5,5,5,5,5,5,17
17,5,5,5,5,5,5,5,17,17,17,17,17,17,17,5,5,5,5,5,5,5,5,17
17,17,17,5,5,5,5,5,5,5,5,5,5,5,5,5,5,5,5,5,5,5,5,17
17,5,5,5,5,5,5,5,5,5,5,5,5,5,5,5,5,5,5,5,5,5,5,17
17,5,5,5,5,5,5,5,5,5,5,5,5,5,5,5,5,5,5,5,5,5,5,17
17,5,5,5,5,5,5,17,5,5,17,17,5,5,17,17,5,5,5,5,5,5,5,17
17,5,5,5,5,5,5,5,5,5,5,5,5,5,5,5,5,5,5,5,5,5,5,17
17,5,5,5,5,5,5,5,5,5,5,5,5,5,5,5,5,5,5,5,5,5,5,17
17,5,5,5,5,5,5,5,5,5,5,5,5,5,5,5,5,5,5,5,5,5,5,17
17,5,5,5,5,5,5,5,5,5,5,5,5,5,5,5,5,5,5,5,5,5,5,17
17,5,5,5,5,5,5,5,5,5,5,5,5,5,5,5,5,5,5,5,5,5,5,17
17,5,5,5,5,5,5,5,5,5,5,5,5,5,5,5,5,5,5,5,5,17,17,17
17,5,5,5,5,5,5,5,5,5,5,5,5,5,5,17,17,5,5,5,5,5,5,17
17,5,5,5,5,5,5,5,5,5,5,5,5,5,5,5,5,5,5,5,5,5,5,17
17,5,5,5,5,5,5,5,5,5,5,5,5,5,5,5,5,5,5,5,5,5,5,17
17,5,5,5,5,17,17,17,5,5,5,5,5,5,5,5,5,5,5,5,5,5,5,17
17,5,5,5,5,5,5,5,5,5,5,5,5,5,5,5,5,5,5,5,5,5,5,17
17,5,5,5,5,5,5,5,5,5,5,5,5,5,5,5,5,5,5,5,5,5,5,17
17,5,5,5,5,5,5,5,5,5,5,5,5,5,5,5,5,5,5,5,5,5,5,17
17,5,5,17,17,5,5,5,5,5,5,5,5,5,5,5,5,5,5,5,5,5,5,17
17,5,5,5,5,5,5,5,5,5,5,5,5,5,5,5,5,5,5,5,5,5,5,17
17,5,5,5,5,5,5,5,5,5,5,5,5,5,5,5,5,5,5,5,5,5,5,17
17,5,5,5,5,5,5,5,5,5,5,5,5,5,5,5,5,5,5,5,5,5,5,17
17,5,5,5,5,5,5,5,5,5,5,5,5,5,5,5,5,5,5,5,5,5,5,17
17,5,5,5,5,5,5,5,5,5,5,5,5,5,5,5,5,5,5,5,5,5,5,17
17,17,5,5,5,5,5,5,5,5,5,5,5,5,5,5,5,5,5,5,5,5,17,17
17,17,17,5,5,5,5,5,5,5,17,17,17,17,5,5,5,5,5,5,5,17,17,17
17,17,17,17,5,5,5,5,5,5,5,5,5,5,5,5,5,5,5,5,17,17,17,17
17,17,17,17,17,5,5,5,5,5,5,5,5,5,5,5,5,5,5,17,17,17,17,17
17,17,17,17,17,17,5,5,5,5,5,5,5,5,5,5,5,5,17,17,17,17,17,17
17,17,17,17,17,17,17,5,5,5,5,5,5,5,5,5,5,17,17,17,17,17,17,17
17,17,17,17,17,17,17,17,5,5,5,5,5,5,5,5,17,17,17,17,17,17,17,17
17,17,17,17,17,17,17,17,17,5,5,5,5,5,5,17,17,17,17,17,17,17,17,17
17,17,17,17,17,17,17,17,17,17,17,17,17,17,17,17,17,17,17,17,17,17,17,17

